###############
#$#####    ####
#$X     ##  $ #
####$####### ##
#### ###      #
#     ### ## ##
##### ### ## ##
##### ### ##  #
##    ### ## ##
## ###### ## ##
## ###### #####
##          $ #
##### #########
#####         O
###############