###############
#X#####    ####
#       ##    #
#### ####### ##
#### ###      #
#     ### ## ##
##### ### ## ##
##### ### ##  #
##    ### ## ##
## ###### ## ##
## ###### #####
##            #
##### #########
#####         O
###############