###############
#X#####    ####
#      $##    #
#### ####### ##
#### ###      #
#     ### ## ##
##### ### ## ##
##### ### ##  #
## $  ### ## ##
## ###### ## ##
## ###### #####
##       $    #
##### #########
#####         O
###############