###############
#X#####    ####
#       ##    #
####$####### ##
#### ###      #
#     ### ## ##
##### ### ## ##
##### ### ##  #
## $  ### ## ##
## ###### ## ##
## ###### #####
##     $      #
##### #########
#####         O
###############