###############
#X#####       #
#       ##### #
# ### #       #
# ### #### ## #
# #        ## #
# # ###### ## #
# # ###### ## #
#       ##    #
## ## #    ## #
#  ## ####### #
# ##  #       #
# ## ###### ###
#             O
###############