###   ## ###N##
#X###N#       #
#       ##N## #
N ### #       N
# N## ##N# N# #
# #        ## #
# # #N###N #N #
N # ###N## ## N
#       ##    #
## N# #    ## #
#  ## #N###N# N
# ##  #       #
N #N ###N## ###
#             O
####N# #N##N###